800,600

285,274,463,274,463,264,285,264
510,274,575,274,575,264,510,264
565,269,565,560,575,560,575,269
575,565,575,555,366,555,366,565

320,565,320,555,285,555,285,565